52 29
22 22
####################################################
#                                                  #
#                                                  #
#       ###################################        #
#                                         #        #
#                                         #        #
#                                         #        #
#             ######################      #        #
#             #                           #        #
#             #                           #        #
#             #                           #        #
#             #      ##########           #        #
#             #               #           #        #
#             #               #           #        #
#             #          S    #           #     G  #
#             #               #           #        #
#             #               #           #        #
#             #      ##########           #        #
#             #                           #        #
#             #                           #        #
#             #                           #        #
#             ######################      #        #
#                                         #        #
#                                         #        #
#                                         #        #
#       ###################################        #
#                                                  #
#                                                  #
####################################################
