72 40
16 16
########################################################################
########################################################################
####           ########################################              ###
####  S        ########################################              ###
#                                                                      #
# ##                                                                 # #
# ##           ##########  #########  #################              # #
# ##           ##########  #########  #################              # #
# ##           ##########  #########  #################              # #
# #######  ##############  #########  #################              # #
# #######  ##############  #########  #######################  ####### #
# #              ###            #        #          #########  ####### #
# #              ###            #        #          #########  ####### #
# #                                                 #########  ####### #
# #                             #        #          #########  ####### #
# #              ###            #        #          #########  ####### #
# #              ###            #        #          #########  ####### #
# #              ################        ####################  ####### #
# #              ###            #        #          #########  ####### #
# #              ###            #        #          #########  ####### #
# ##################            #        #                     ####### #
#                                                              ####### #
######### ##########            #        #          ################## #
######### ##########            #        #          ################## #
######### #######################        ############################# #
#       # #       ##            #        #          ################## #
#       # #       ##            #        #          ################## #
#         #            G                                      ######## #
#       # #       ##            #        #          ########  ######## #
######### ####  ####            #        #          ########  ######## #
#       # #       ##################  ######################  ######## #
#       # #       ##################  ######################           #
#                 ##                                ########  ##########
#       # #       ##                                ########  ##########
#### #### ##########                                          ##########
#### #### ##########                                          ##########
####                                                ####################
####################                                ####################
########################################################################
########################################################################
